{
    "Enemies": {
        "Boombas": [
            {
                "end col": 1,
                "end row": 7,
                "speed": 3,
                "start col": 6,
                "start row": 7
            },
            {
                "end col": 5,
                "end row": 9,
                "speed": 3,
                "start col": 9,
                "start row": 7
            },
            {
                "end col": 8,
                "end row": 11,
                "speed": 3,
                "start col": 4,
                "start row": 10
            },
            {
                "end col": 7,
                "end row": 18,
                "speed": 3,
                "start col": 4,
                "start row": 13
            },
            {
                "end col": 8,
                "end row": 73,
                "speed": 3,
                "start col": 10,
                "start row": 70
            },
            {
                "end col": 8,
                "end row": 91,
                "speed": 3,
                "start col": 10,
                "start row": 81
            },
            {
                "end col": 4,
                "end row": 85,
                "speed": 3,
                "start col": 1,
                "start row": 82
            }
        ],
        "Sweepers": [
            {
                "end col": 3,
                "end row": 6,
                "start col": 9,
                "start row": 6
            },
            {
                "end col": 5,
                "end row": 30,
                "start col": 10,
                "start row": 30
            },
            {
                "end col": 10,
                "end row": 45,
                "start col": 5,
                "start row": 45
            },
            {
                "end col": 0,
                "end row": 60,
                "start col": 8,
                "start row": 60
            },
            {
                "end col": 1,
                "end row": 104,
                "start col": 1,
                "start row": 77
            }
        ]
    },
    "Floor": {
        "CSV": [
            "1| | ,1| | ,1| | ,1| | ,1| | ,1| | ,1| | ,1| | ,1| | ,1| | ,1| | ",
            "1| | ,1| | ,1| | ,1| | ,1| | ,S| | ,1| | ,1| | ,1| | ,1| | ,1| | ",
            "1| | ,1| | ,1| | ,1| | ,1| | ,1| | ,1| | ,1| | ,1| | ,1| | ,1| | ",
            "1| | ,1| | ,1| | ,1| | ,1| | ,1| | ,1| | ,1| | ,1| | ,1| | ,1| | ",
            "1| | ,1| | ,1| | ,1| | ,1| | ,1| | ,1| | ,1| | ,1| | ,1| | ,1| | ",
            "1| | ,1| | ,1| | ,1| | ,1| | ,1| | ,1| | ,1| | ,1| | ,1| | ,1| | ",
            "1| | ,1| | ,1| | ,1| | ,1| | ,1| | ,1| | ,1| | ,1| | ,1| | ,1| | ",
            "1| | ,1| | ,1| | ,1| | ,1| | ,1| | ,1| | ,1| | ,1| | ,1| | ,1| | ",
            "1| | ,1| | ,1| | ,1| | ,1| | ,1| | ,1| | ,1| | ,1| | ,1| | ,1| | ",
            "1| | ,1| | ,1| | ,1| | ,1| | ,1| | ,1| | ,1| | ,1| | ,1| | ,1| | ",
            "1| | ,1| | ,1| | ,1| | ,1| | ,1| | ,1| | ,1| | ,1| | ,1| | ,1| | ",
            "1| | ,1| | ,1| | ,1| | ,1| | ,1| | ,1| | ,1| | ,1| | ,1| | ,1| | ",
            "1| | ,1| | ,1| | ,1| | ,1| | ,1| | ,1| | ,1| | ,1| | ,1| | ,1| | ",
            "1| | ,1| | ,1| | ,1| | ,1| | ,1| | ,1| | ,1| | ,1| | ,1| | ,1| | ",
            "1| | ,1| | ,1| | ,1| | ,1| | ,1| | ,1| | ,1| | ,1| | ,1| | ,1| | ",
            "1| | ,1| | ,1| | ,1| | ,1| | ,1| | ,1| | ,1| | ,1| | ,1| | ,1| | ",
            "1| | ,1| | ,1| | ,1| | ,1| | ,1| | ,1| | ,1| | ,1| | ,1| | ,1| | ",
            "1| | ,1| | ,1| | ,1| | ,1| | ,1| | ,1| | ,1| | ,1| | ,1| | ,1| | ",
            "1| | ,1| | ,1| | ,1| | ,1| | ,1| | ,1| | ,1| | ,1| | ,1| | ,1| | ",
            "1| | ,1| | ,1| | ,1| | ,1| | ,1| | ,1| | ,1| | ,1| | ,1| | ,1| | ",
            "1| | ,1| | ,1| | ,1| | ,1| | ,1| | ,1| | ,1| | ,1| | ,1| | ,1| | ",
            "0| | ,1| | ,1| | ,1| | ,1| | ,1| | ,1| | ,1| | ,1| | ,1| | ,0| | ",
            "0| | ,0| | ,1| | ,1| | ,1| | ,1| | ,1| | ,1| | ,1| | ,0| | ,0| | ",
            "0| | ,0| | ,0| | ,1| | ,1| | ,1| | ,1| | ,1| | ,0| | ,0| | ,0| | ",
            "0| | ,0| | ,0| | ,0| | ,1| | ,C| | ,1| | ,0| | ,0| | ,0| | ,0| | ",
            "0| | ,0| | ,0| | ,1| | ,1| | ,1| | ,1| | ,1| | ,0| | ,0| | ,0| | ",
            "0| | ,0| | ,1| | ,1| | ,1| | ,1| | ,1| | ,1| | ,1| | ,0| | ,0| | ",
            "0| | ,1| | ,1| | ,1| | ,1| | ,1| | ,1| | ,1| | ,1| | ,1| | ,0| | ",
            "1| | ,1| | ,1| | ,1| | ,1| | ,0| | ,1| | ,1| | ,1| | ,1| | ,1| | ",
            "1| | ,1| | ,1| | ,1| | ,0| | ,0| | ,0| | ,1| | ,1| | ,1| | ,1| | ",
            "1| | ,1| | ,1| | ,0| | ,0| | ,0| | ,0| | ,0| | ,1| | ,1| | ,1| | ",
            "1| | ,1| | ,1| | ,0| | ,0| | ,0| | ,0| | ,0| | ,1| | ,1| | ,1| | ",
            "1| | ,1| | ,1| | ,0| | ,0| | ,0| | ,0| | ,0| | ,1| | ,1| | ,1| | ",
            "1| | ,1| | ,1| | ,0| | ,0| | ,0| | ,0| | ,0| | ,1| | ,1| | ,1| | ",
            "1| | ,1| | ,1| | ,0| | ,0| | ,0| | ,0| | ,0| | ,1| | ,1| | ,1| | ",
            "1| | ,1| | ,1| | ,0| | ,0| | ,0| | ,0| | ,0| | ,1| | ,1| | ,1| | ",
            "1| | ,1| | ,1| | ,0| | ,0| | ,0| | ,0| | ,0| | ,1| | ,1| | ,1| | ",
            "1| | ,1| | ,1| | ,0| | ,0| | ,0| | ,0| | ,0| | ,1| | ,1| | ,1| | ",
            "1| | ,1| | ,1| | ,0| | ,0| | ,0| | ,0| | ,0| | ,1| | ,1| | ,1| | ",
            "1| | ,1| | ,1| | ,0| | ,0| | ,0| | ,0| | ,0| | ,1| | ,1| | ,1| | ",
            "1| | ,1| | ,1| | ,0| | ,0| | ,0| | ,0| | ,0| | ,1| | ,1| | ,1| | ",
            "1| | ,1| | ,1| | ,0| | ,0| | ,0| | ,0| | ,0| | ,1| | ,1| | ,1| | ",
            "1| | ,1| | ,1| | ,0| | ,0| | ,0| | ,0| | ,0| | ,1| | ,1| | ,1| | ",
            "1| | ,1| | ,1| | ,0| | ,0| | ,0| | ,0| | ,0| | ,1| | ,1| | ,1| | ",
            "1| | ,1| | ,1| | ,1| | ,0| | ,0| | ,0| | ,1| | ,1| | ,1| | ,1| | ",
            "1| | ,1| | ,1| | ,1| | ,1| | ,0| | ,1| | ,1| | ,1| | ,1| | ,1| | ",
            "1| | ,1| | ,1| | ,1| | ,1| | ,1| | ,1| | ,1| | ,1| | ,1| | ,1| | ",
            "0| | ,1| | ,1| | ,1| | ,1| | ,1| | ,1| | ,1| | ,1| | ,1| | ,0| | ",
            "0| | ,0| | ,1| | ,1| | ,1| | ,1| | ,1| | ,1| | ,1| | ,0| | ,0| | ",
            "0| | ,0| | ,0| | ,1| | ,1| | ,C| | ,1| | ,1| | ,0| | ,0| | ,0| | ",
            "0| | ,0| | ,0| | ,1| | ,1| | ,1| | ,1| | ,0| | ,0| | ,0| | ,0| | ",
            "0| | ,0| | ,1| | ,1| | ,1| | ,1| | ,0| | ,0| | ,0| | ,0| | ,0| | ",
            "0| | ,0| | ,1| | ,1| | ,1| | ,1| | ,0| | ,0| | ,0| | ,0| | ,0| | ",
            "0| | ,1| | ,1| | ,1| | ,1| | ,0| | ,0| | ,0| | ,0| | ,0| | ,0| | ",
            "0| | ,1| | ,1| | ,1| | ,1| | ,0| | ,0| | ,0| | ,0| | ,0| | ,0| | ",
            "1| | ,1| | ,1| | ,1| | ,0| | ,0| | ,0| | ,0| | ,0| | ,0| | ,0| | ",
            "1| | ,1| | ,1| | ,1| | ,0| | ,0| | ,0| | ,0| | ,0| | ,0| | ,0| | ",
            "1| | ,1| | ,1| | ,0| | ,0| | ,0| | ,0| | ,0| | ,0| | ,0| | ,0| | ",
            "1| | ,1| | ,1| | ,0| | ,0| | ,0| | ,0| | ,0| | ,0| | ,0| | ,0| | ",
            "1| | ,1| | ,1| | ,0| | ,0| | ,0| | ,0| | ,0| | ,0| | ,0| | ,0| | ",
            "1| | ,1| | ,1| | ,0| | ,0| | ,0| | ,0| | ,0| | ,0| | ,0| | ,0| | ",
            "1| | ,1| | ,1| | ,0| | ,0| | ,0| | ,0| | ,0| | ,0| | ,0| | ,0| | ",
            "1| | ,1| | ,1| | ,1| | ,0| | ,0| | ,0| | ,0| | ,0| | ,0| | ,0| | ",
            "1| | ,1| | ,1| | ,1| | ,1| | ,0| | ,0| | ,0| | ,0| | ,0| | ,0| | ",
            "0| | ,1| | ,1| | ,1| | ,1| | ,1| | ,0| | ,0| | ,0| | ,0| | ,0| | ",
            "0| | ,0| | ,1| | ,1| | ,1| | ,1| | ,1| | ,0| | ,0| | ,0| | ,0| | ",
            "0| | ,0| | ,0| | ,1| | ,1| | ,1| | ,1| | ,1| | ,0| | ,0| | ,0| | ",
            "0| | ,0| | ,0| | ,1| | ,1| | ,1| | ,1| | ,1| | ,1| | ,0| | ,0| | ",
            "0| | ,0| | ,0| | ,0| | ,1| | ,1| | ,1| | ,1| | ,1| | ,1| | ,0| | ",
            "0| | ,0| | ,0| | ,0| | ,0| | ,1| | ,1| | ,1| | ,1| | ,1| | ,1| | ",
            "0| | ,0| | ,0| | ,0| | ,0| | ,0| | ,1| | ,1| | ,1| | ,1| | ,1| | ",
            "0| | ,0| | ,0| | ,0| | ,0| | ,0| | ,0| | ,1| | ,1| | ,1| | ,1| | ",
            "0| | ,0| | ,0| | ,0| | ,0| | ,0| | ,0| | ,0| | ,1| | ,1| | ,1| | ",
            "0| | ,0| | ,0| | ,0| | ,0| | ,0| | ,0| | ,0| | ,1| | ,1| | ,1| | ",
            "0| | ,0| | ,0| | ,0| | ,0| | ,0| | ,0| | ,0| | ,1| | ,1| | ,1| | ",
            "0| | ,0| | ,0| | ,0| | ,0| | ,0| | ,0| | ,0| | ,1| | ,1| | ,1| | ",
            "0| | ,0| | ,0| | ,0| | ,0| | ,0| | ,0| | ,0| | ,1| | ,1| | ,1| | ",
            "0| | ,0| | ,1| | ,1| | ,1| | ,1| | ,0| | ,0| | ,1| | ,1| | ,1| | ",
            "0| | ,0| | ,1| | ,1| | ,F| | ,1| | ,0| | ,0| | ,1| | ,C| | ,1| | ",
            "0| | ,0| | ,1| | ,1| | ,1| | ,1| | ,0| | ,0| | ,1| | ,1| | ,1| | ",
            "0| | ,0| | ,1| | ,1| | ,1| | ,1| | ,0| | ,0| | ,1| | ,1| | ,1| | ",
            "0| | ,1| | ,1| | ,1| | ,1| | ,0| | ,0| | ,0| | ,1| | ,1| | ,1| | ",
            "0| | ,1| | ,1| | ,1| | ,1| | ,0| | ,0| | ,0| | ,1| | ,1| | ,1| | ",
            "0| | ,1| | ,1| | ,1| | ,1| | ,0| | ,0| | ,0| | ,1| | ,1| | ,1| | ",
            "0| | ,1| | ,1| | ,1| | ,1| | ,0| | ,0| | ,0| | ,1| | ,1| | ,1| | ",
            "1| | ,1| | ,1| | ,0| | ,0| | ,0| | ,0| | ,0| | ,1| | ,1| | ,1| | ",
            "1| | ,1| | ,1| | ,0| | ,0| | ,0| | ,0| | ,0| | ,1| | ,1| | ,1| | ",
            "1| | ,1| | ,1| | ,0| | ,0| | ,0| | ,0| | ,0| | ,1| | ,1| | ,1| | ",
            "1| | ,1| | ,1| | ,0| | ,0| | ,0| | ,0| | ,0| | ,1| | ,1| | ,1| | ",
            "1| | ,1| | ,1| | ,0| | ,0| | ,0| | ,0| | ,0| | ,1| | ,1| | ,1| | ",
            "1| | ,1| | ,1| | ,0| | ,0| | ,0| | ,0| | ,0| | ,1| | ,1| | ,1| | ",
            "1| | ,1| | ,1| | ,0| | ,0| | ,0| | ,0| | ,0| | ,1| | ,1| | ,1| | ",
            "1| | ,1| | ,1| | ,0| | ,0| | ,0| | ,0| | ,0| | ,1| | ,1| | ,1| | ",
            "1| | ,1| | ,1| | ,0| | ,0| | ,0| | ,0| | ,0| | ,1| | ,1| | ,1| | ",
            "1| | ,1| | ,1| | ,0| | ,0| | ,0| | ,0| | ,0| | ,1| | ,1| | ,1| | ",
            "1| | ,1| | ,1| | ,0| | ,0| | ,0| | ,0| | ,0| | ,1| | ,1| | ,1| | ",
            "1| | ,1| | ,1| | ,0| | ,0| | ,0| | ,0| | ,0| | ,1| | ,1| | ,1| | ",
            "1| | ,1| | ,1| | ,0| | ,0| | ,0| | ,0| | ,0| | ,1| | ,1| | ,1| | ",
            "1| | ,1| | ,1| | ,0| | ,0| | ,0| | ,0| | ,0| | ,1| | ,1| | ,1| | ",
            "1| | ,1| | ,1| | ,0| | ,0| | ,0| | ,0| | ,0| | ,1| | ,1| | ,1| | ",
            "1| | ,1| | ,1| | ,1| | ,0| | ,0| | ,0| | ,1| | ,1| | ,1| | ,1| | ",
            "1| | ,1| | ,1| | ,1| | ,1| | ,1| | ,1| | ,1| | ,1| | ,1| | ,1| | ",
            "0| | ,1| | ,1| | ,1| | ,1| | ,1| | ,1| | ,1| | ,1| | ,1| | ,0| | ",
            "0| | ,0| | ,1| | ,1| | ,1| | ,1| | ,1| | ,1| | ,1| | ,0| | ,0| | "
        ],
        "DEFAULT_FRICTION": 0.1,
        "TILE_SIZE": 8
    },
    "HighScore": 0,
    "Name": "Map 1",
    "Pins": [
        {
            "col": 6,
            "row": 6
        },
        {
            "col": 6,
            "row": 16
        },
        {
            "col": 1,
            "row": 38
        },
        {
            "col": 9,
            "row": 33
        },
        {
            "col": 9,
            "row": 38
        },
        {
            "col": 9,
            "row": 42
        },
        {
            "col": 1,
            "row": 60
        },
        {
            "col": 9,
            "row": 95
        },
        {
            "col": 2,
            "row": 102
        },
        {
            "col": 3,
            "row": 81
        }
    ],
    "PowerUps": [
        {
            "col": 5,
            "row": 20,
            "type": 11
        },
        {
            "col": 3,
            "row": 3,
            "type": 12
        },
        {
            "col": 7,
            "row": 3,
            "type": 13
        },
        {
            "col": 9,
            "row": 74,
            "type": 12
        }
    ]
}
